111111111111
10010000B0C1
100001110001
1P0011E000B1
111111111111