1111111
1E000C1
1000001
100P001
1000001
1E000C1
1111111